11111
100E1
1C0C1
1P001
11111
