1111111111111111111111111111
1000000000000000000000000001
1000000000000000000000000001
10P1110000000000000C00000001
10E0000000000000000000000001
1111111111111111111111111111
